+--+--+--+--+--+
aaaa++ggg++++++|
+++c+-e+g-+--+-|
|++d|-e+g-+--+-|
+++e--e-g+--+--+
|++fghfgh+--+--+
+--+-+--+--+-E-|
|++d+|--|++++++|
+a|e+|+-+++++++|
|+bcdabcdsadsE+|
+--+--+--+--+--+