+--+--+--+--+--+
aaaaaaaaaaaaaaE|
+b+c+--+--+--+-|
|d++|--+--+--+-|
+e++--+--+--+--+
|fgfg-+--+--+--+
+--+h-+--+--+--|
|a+|d+|--|d+bcE|
+a+|e+|E-+d+a++|
|abcdabcdsadsda|
+--+--+--+--+--+